tropical = {}
arid = {}
arctic = {}

mild_winter = {
	4 5 7 10 15 17 21 22 24 26 27 29 30 31 32 33 34 35 36 39 40 41 54 55 56 70 72 81 82 90 91 92 93 94 95 98 99 100 116
    118 121 123 124 125 126 128 132 135 136 138 139 140 141 142 143 146 147 148 149 151 152 153 154 155 156 157 158 159
    160 161 162 163 164 181 183 188 189 219 222 223 226 235 236 238 243 254 255 256 257 258 259 260 261 262 265 266 268
    269 270 272 273 275 276 277 279 280 283 285 286 287 291 292 294 298 299 300 302 311 314 316 317 320 322 324 325 326
    327 328 330 331 332 333 334 335 336 337 339 340 342 343 344 348 351 362 363 364 365 370 371 377 378 379 381 382 384
    390 396 397 399 407 408 411 413 414 417 418 419 421 422 424 426 429 430 434 438 441 444 445 449 455 456 462 467 476
    478 479 481 491 495 496 497 498 510 512 514 522 538 543 547 548 552 571 575 576 583 584 585 587 592 602 615 616 625
    627 628 629 634 635 644 654 657 658 660 665 672 673 676 678 680 688 690 694 695 696 698 701 705 710 712
    722 724 736 740 745 748 749 750 751 752 753 754 756 762 764 765 771 772 774 783 793 798 799 805 807 809 811 814
    825 832 847 848 853 855 856 863 864 865 866 867 868 869 873 875 876 877 878 879 884 888 891 892 893 895 896 897 900
    907 908 909 918 919 920 921 927 929 930 931 934 935 936 940 962 963 975 980 981 983 985 986 988 994 995 996 997 1015 1016
    1027 1029 1032 1035 1042 1043 1047 1050 1056 1057 1067 1071 1075 1076 1078 1084 1085 1090 1091 1097 1099 1100 1107
    1113 1132 1133 1145 1147 1151 1161 1162 1164 1165 1166 1167 1168 1169 1170 1171 1172 1174 1175 1177 1183 1185
    1191 1194 1195 1197 1199 1200 1201 1203 1204 1205 1214 1216 1229 1231 1233 1234 1238 1242 1246 1248 1252 1253 1254
    1255 1256 1257 1258 1259 1263 1264 1265 1266 1267 1271 1277 1282 1287 1288 1289 1290 1306 1318 1742 1747 1754 1758
    1759 1764 1765 1766 1767 1770 1773 1775 1776 1789 1792 1796 1802 1807 1809 1810 1811 1816 1826 1827 1829 1831 1832 1838
    1841 1846 1848 1849 1850 1852 1853 1854 1855 1856 1859 1860 1863 1864 1866 1878 1882 1901 1925 1930 1931 1934 1935
    1936 1937 1940 1942 1943 1944 1945 1947 1948 1950 1951 1953 1954 1957 1958 1967 1973 1982 1985 1990 1991 1994
    1997 2003 2004 2005 2006 2007 2008 2020 2023 2031 2032 2035 2059 2061 2063 2065 2067 2068 2072 2073 2078 2088 2099 2101
    2107 2115 2121 2122 2130 2132 2133 2141 2143 2154 2155 2156 2160 2162 2163 2165 2166 2167 2169 2170 2173 2177 2179
    2181 2188 2192 2200 2203 2204 2205 2207 2210 2212 2213 2215 2217 2219 2221 2227 2230 2238 2240 2243 2250 2256 2262
    2268 2272 2274 2289 2294 2295 2299 2303 2305 2306 2308 2312 2316 2317 2319 2320 2321 2324 2327 2328 2331 2338
    2354 2357 2358 2359 2361 2362 2366 2370 2373 2378 2381 2382 2383 2384 2385 2389 2392 2396 2399 2405 2406 2407
    2408 2409 2411 2412 2424 2428 2429 2434 2438 2441 2447 2457 2458 2459 2460 2462 2463 2464 2466 2467 2468 2469 2471
    2476 2477 2478 2480 2482 2483 2488 2489 2490 2491 2493 2495 2498 2499 2501 2502 2504 2505 2506 2508 2509 2510 2512
    2514 2515 2520 2527 2528 2529 2532 2535 2536 2537 2538 2539 2540 2541 2546 2564 2566 2568 2571 2572 2573 2574
    2575 2577 2578 2579 2582 2593 2596 2599 2606 2609 2611 2614 2615 2616 2617 2619 2620 2622 2624 2627 2628 2629 2630
    2644 2645 2646 2647 2648 2653 2668 2690 2691 2692 2696 2698
    2699 2700 2704 2723 2724 2728 2729 2730 2731 2732 2736 2737 2745 2746 2749 2750 2751 2762 2766 2774 2775 2778 2784
    2787 2796 2797 2798 2800 2818 2824 2827 2840 2843 2845 2849 2855 2856 2862 2864 2868 2874 2875 2885
    2886 2887 2888 2897 2898 2899 2900 2909 2913 2915 2916 2917 2918 2919 2922 2925 2927 2930 2946 2948 2949
    2951 2959 2960 2962 2963 2971 2972 2973 2975 2976 2982 2984 2986 2988 2995 2997 2998 2999 3000 3002 3003 3084 3085
    3086 3087 3088 3089 3090 3091 3092 3093 3094 3095 3096 3097 3098 3099 3100 3101 3102 3103 3104 3105 3106 3107 3128
    3129 3130 3131 3132 3133 3134 3135 3192 3194 3195 3196 3197 3218 3222 3693 3763 3785 3786 3787 3788 3789 3790 3792
    3793 3806 4020 4021 4022 4023 4024 4025 4028 4031 4032 4034 4035 4036 4037 4038
    4039 4040 4042 4043 4044 4045 4046 4047 4048 4049 4051 4054 4057 4059 4060 4062 4068 4069 4070 4078 4079 4080 4081
    4082 4083 4084 4085 4087 4088 4089 4090 4091 4092 4093 4094 4095 4096 4098 4099 4100 4102 4103 4104 4105 4106 4107
    4108 4109 4110 4115 4116 4117 4121 4122 4123 4125 4129 4130 3190 4323 4324 4325 4326 4327 4328 4329 4330 4331 4332
    4333 4348 4349 4350 4351 4352 4353 4354 4355 4360 4366 4444 4445 4446 4447 4451 4452 4454 4465 4488 4489 4490 4491
    4492 4493 4494 4495 4496 4497 4498 4499 4500 4713 4714 4715 4716 4717 4718 4719 4720 4721 4722 4723 4724 4729 4803
    4877 4887 4888 4889 4890 4891 4894 4896 5158 5159 5160 5222 5223 5224 5225 5226 5227 5228 5229 5230 5231 5232 5233
    5234 5235 5236 5237 5238 5239 5240 5241 5242 5243 5244 5245 5270 5271 5272 5273 5274 5307 5322 5323 5338 5339 5340
    5351 5352 5353 5354 5355 5384 5385 5388 5389 5390 5391 5395 5397 5473 5474 5475 5476 5477 5478 5479 5480 5481 5482
    5483 5486 5487 5488 5489 5490 5491 5492 5493 5494 5501 5502 5503 5504 5505 5506 5507 5508 5509 5510 5513 5521 5523
    5524 5526 5530 5533 5538 5543 5550 5571 5572 5574 5575 5576 5599 5600 5601 5602 5603 5604 5605 5606 5607 5608 5609
    5610 5611 5612 5613 5615 5616 5617 5618 5619 5620 5624 5625 5626 5633 5635 5636 5648 5649 5656 5657 5658 5673 5674
    5675 5676 5677 5678 5679 5680 5681 5682 5683 5684 5690 5691 5692 5693 5694 5695 5701 5702 5923 5924 5926 5947 5948
    5949 5950 6046 6047

    6433 6434 6435 6436 6437 6438 6439 6440 6441 6442 6443 6409 6408
    6382 6383 6384 6385 6386 6387 6388 6389 6390 6391 6392 6393 6394
    6395 6396 6397 6398 6399 6400 6401 6402 6403 6404 6405 6406 6407
    6349 6350 6351 6352 6353 6354 6355 6356 6357 6358 6359 6360 6361 6362 6363 6348
}

normal_winter = {
	3 6 8 11 12 13 14 16 18 23 25 28 37 38 43 44 45 46 47 48 49 50 51 52 53 58 59 60 61 62 63 64 65 66 67 69 71 75 76
    77 78 79 83 84 85 86 87 88 89 96 97 102 103 104 105 107 108 110 111 114 119 120 122 127 131 134 144 145 150 165 166
    167 168 170 172 174 177 178 179 184 185 190 194 195 197 198 199 201 204 206 207 208 209 212 215 216 217 218 221 224
    225 227 228 229 230 231 232 233 234 239 240 241 242 244 245 246 247 248 249 250 251 252 253 263 274 278 281 282 289
    293 295 297 301 304 307 308 309 310 315 329 338 341 345 346 347 349 350 353 354 357 358 359 360 361 369 372 373 374
    375 376 380 386 387 388 391 393 394 398 402 405 406 409 410 412 415 416 420 420 439 440 442 447 448 450 452 453 454
    458 463 466 468 470 471 472 477 480 482 483 486 487 502 513 534 535 536 537 539 540 542 549 553 554 561 563 572 574
    579 585 588 589 593 604 605 606 607 608 609 610 613 617 618 620 621 626 631 632 633 636 641 643 656 660 661 662 664 667
    671 674 675 677 679 683 685 686 693 699 703 706 709 712 720 721 723 730 733 739 741 746 747 755 757 760 766 768 770
    773 775 776 778 779 781 782 785 786 787 790 792 794 795 802 803 804 806 810 812 813 815 816 817 818 819 820 822 823
    826 827 828 829 830 831 834 835 837 838 839 841 842 843 845 846 850 851 852 854 857 858 859 860 861 862 880 881 882
    883 885 887 889 890 894 901 903 904 905 910 910 911 912 913 916 922 923 928 932 933 937 938 941 947 948 949 950 951
    952 953 955 959 960 961 964 965 978 982 992 1000 1011 1018 1021 1034 1036 1037 1038 1039 1040 1041 1044 1046 1055
    1061 1064 1065 1068 1069 1070 1072 1073 1074 1077 1086 1092 1094 1101 1102 1103 1104 1105 1110 1114 1116 1117 1124
    1125 1129 1136 1137 1138 1139 1140 1146 1148 1149 1154 1155 1156 1157 1158 1159 1190 1196 1207 1210 1213 1217 1218
    1223 1224 1226 1227 1228 1232 1235 1743 1744 1745 1746 1748 1749 1750 1751 1752 1755 1756 1757 1760 1761 1762 1763
    1771 1772 1777 1778 1794 1795 1799 1815 1820 1821 1823 1830 1833 1842 1844 1845 1851 1857 1858 1861 1865 1868 1869
    1870 1871 1872 1874 1875 1876 1879 1880 1933 1938 1941 1956 1959 1960 1961 1962 1965 1966 1968 1969 1970 1971 1978
    1979 1981 1983 1984 1987 1993 1998 1999 2009 2011 2014 2016 2017 2021 2026 2027 2038 2039 2043 2044 2048 2060 2064
    2069 2070 2074 2075 2079 2080 2081 2083 2096 2100 2110 2112 2125 2126 2127 2135 2136 2140 2142 2145 2146 2151
    2153 2158 2161 2168 2171 2172 2180 2184 2187 2195 2196 2197 2198 2199 2201 2202 2206 2208 2209 2211 2224 2228 2229
    2232 2239 2242 2244 2245 2247 2248 2254 2255 2257 2258 2261 2266 2267 2269 2275 2276 2279 2281 2282 2285 2291 2292
    2293 2300 2301 2302 2304 2307 2309 2310 2311 2313 2314 2315 2323 2325 2326 2328 2329 2331 2338 2343 2345 2351 2352
    2356 2360 2364 2369 2372 2375 2376 2401 2402 2410 2413 2415 2416 2417 2419 2427 2430 2431 2432 2433 2436 2437 2439
    2442 2443 2445 2448 2449 2450 2451 2452 2454 2455 2461 2465 2470 2473 2474 2475 2481 2492 2494 2496 2497 2500 2507
    2511 2516 2517 2518 2519 2523 2524 2525 2526 2530 2533 2534 2542 2543 2544 2545 2547 2548 2550 2552 2553 2554 2555
    2557 2567 2569 2586 2589 2591 2592 2598 2618 2621 2623 2625 2626 2631 2632 2633 2634 2635 2636 2637 2638 2640 2641
    2642 2643 2649 2650 2651 2652 2657 2658 2659 2660 2661 2662 2663 2664 2665 2666 2667 2672 2680 2681 2685 2689 2694
    2695 2697 2712 2715 2717 2725 2726 2727 2733 2738 2741 2744 2748 2752 2753 2754 2756 2757 2758 2759 2760 2761 2763
    2764 2765 2767 2768 2769 2770 2771 2772 2779 2781 2783 2785 2789 2790 2793 2794 2795 2799 2803 2804 2805 2806 2807
    2808 2809 2810 2811 2812 2814 2815 2817 2821 2822 2823 2825 2826 2831 2832 2833 2834 2835 2837 2838 2840 2841 2842
    2844 2845 2846 2847 2848 2851 2852 2857 2858 2859 2861 2863 2866 2867 2869 2870 2871 2872 2876 2877 2878 2879 2883
    2884 2889 2890 2891 2893 2895 2902 2902 2904 2907 2908 2911 2912 2914 2923 2926 2928 2929 2931 2933 2934 2935 2937
    2938 2939 2940 2941 2943 2945 2954 2955 2956 2957 2958 2961 2964 2965 2967 2969 2970 2979 2981 2985 2989 2990
    2991 2993 2994 2996 3001 3004 3005 3006 3007 3008 3010 3011 3012 3013 3014 3015 3016 3017 3018 3019 3020 3200 3202
    3204 3205 3207 3209 3210 3211 3212 3213 3214 3239 3240 3286 3287 3288 3289 3290 3291 3292 3293 3294 3295 3296 3297
    3298 3299 3300 3301 3302 3303 3304 3305 3306 3307 3308 3309 3315 3317 3318 3319 3320 3321 3322 3323 3324 3325 3326
    3327 3328 3329 3330 3331 3339 3346 3347 3348 3349 3350 3351 3352 3353 3354 3355 3356 3365 3367 3368 3369 3370 3371
    3372 3374 3390 3391 3392 3393 3394 3395 3396 3397 3791 3794 3795 3796 3797 3798 3799 3973 4033 4052 4111 4112 4113
    4114 4118 4119 4120 4126 4127 4128 4131 4227 4235 4236 4237 4238 4239 4240 4241 4242 4243 4245 4246 4247 4248
    4249 4250 4251 4252 4253 4254 4255 4256 4257 4258 4259 4260 4261 4262 4263 4264 4265 4266 4267 4268 4269 4270 4271
    4272 4273 4274 4275 4276 4277 4278 4279 4280 4281 4282 4283 4284 4285 4289 4290 4291 4292 4542 4548 4551 4706 4707
    4725 4726 4727 4728 4730 4791 4792 4797 4799 4800 4804 4805 4807 4808 4809 4810 4811 4812 4813 4814 4815 4816 4817
    4818 4819 4820 4821 4822 4823 4824 4825 4826 4827 4828 4829 4830 4831 4832 4833 4834 4835 4836 4837 4838 4839 4840
    4841 4842 4843 4844 4845 4846 4847 4848 4849 4850 4851 4852 4853 4854 4855 4857 4858 4859 4860 4861 4868 4876 4883
    4885 4886 4892 4893 4895 4897 4899 4901 4902 4903 4904 4905 4906 4907 4908 4909 4910 4911 4912 4913 4914 4915 4916
    4917 4918 4919 5114 5130 5131 5132 5133 5134 5135 5136 5140 5141 5142 5143 5144 5145 5146 5147 5148 5149 5150 5151
    5152 5153 5154 5156 5161 5162 5189 5196 5198 5246 5247 5248 5249 5250 5251 5252 5253 5254 5255 5256 5257 5258 5259
    5260 5261 5262 5263 5264 5265 5266 5267 5268 5276 5277 5379 5392 5393 5394 5396 5398 5399 5400 5401 5402 5403 5404
    5405 5406 5407 5408 5411 5414 5426 5427 5428 5432 5455 5456 5457 5458 5459 5460 5461 5467 5468 5469 5470 5471 5472
    5485 5495 5496 5497 5498 5499 5500 5514 5515 5516 5517 5518 5519 5520 5525 5527 5528 5529 5531 5532 5534 5536 5537
    5540 5542 5544 5545 5546 5547 5548 5549 5551 5552 5554 5555 5556 5557 5560 5561 5567 5569 5573 5578 5579 5580 5582
    5584 5585 5586 5588 5589 5590 5591 5592 5593 5594 5595 5596 5598 5614 5621 5622 5623 5627 5628 5629 5630 5631 5632
    5634 5637 5638 5639 5640 5641 5642 5643 5644 5645 5646 5647 5650 5651 5652 5653 5654 5655 5659 5660 5661 5662 5663
    5664 5665 5666 5667 5668 5669 5670 5671 5672 5685 5686 5687 5688 5689 5696 5697 5698 5699 5700 5703 5704 5705 5706
    5707 5708 5709 5710 5711 5712 5713 5714 5715 5716 5717 5718 5719 5720 5721 5722 5723 5724 5725 5726 5727 5728 5729
    5730 5731 5732 5733 5734 5735 5736 5737 5738 5739 5740 5741 5742 5743 5744 5745 5746 5747 5748 5749 5750 5751 5752
    5753 5754 5755 5756 5757 5758 5759 5760 5761 5762 5763 5764 5765 5766 5767 5768 5769 5770 5771 5772 5773 5774 5775
    5776 5777 5778 5779 5780 5781 5782 5783 5784 5785 5786 5787 5788 5789 5790 5791 5792 5793 5794 5795 5796 5797 5798
    5799 5800 5801 5802 5803 5804 5805 5806 5807 5808 5809 5810 5811 5812 5813 5814 5815 5816 5817 5818 5819 5820 5821
    5822 5823 5824 5825 5826 5827 5829 5830 5840 5841 5897 5898 5899 5900 5901 5902 5903 5904 5905 5906
    5907 5908 5909 5910 5911 5912 5913 5914 5925 5927 5928 5933 5934 5935 5936 5937 5938 5939 5940 5941 5942 5943 5944
    5945 5946 5952 5954 5955 5957 5958 5961 5962 5963 5964 5965 5966 5967 5968 5969 5970 5971 5972 5973 5974 5975 5976
    5977 5978 5979 5980 5981 5982 5983 5984 5985 5986 5987 5988 5989 5990 5991 5992 5993 5994 5995 5996 5997 5998 5999
    6000 6044 6045 6130 6131 

    5831 5832 5833 5834 5835 5836 5837 5838 5839 5842 5843 5844 5845 5846 5847
    5848 5849 5850 5851 5852 5853 5854 5855 5856 5857 5858 5859 5860 5861 5862
    5863 5864 5865 5866 5867 5868 5869 5870 5871 5872 5873 5874 5875 5876 5877
    5878 5879 5880 5881 5882 5883 5884 5885 5886 5887 5888 5889 5890 5891 5892
    5893 5894 5895 5896 3415 3416 3417 3418 3419 3420 3421 3422 3423 3424 3425
    3426 3427 3428 3429 6132 3398
    3807 3808 3809 3810 3811 3812 3813 3814 3815 3816 3817 3818 3819 3820 3821 3822 3823
    3824 3825 3826 3827 3828 3829 3830 3831 3832 3833 3834 3835 3836 3837 3838 3839 3840
    3841 3842 3843 3844 3845 3846 3847 3848 3849 3850 3851 3852 3853 3854 3855 3856 3857
    3858 3859 3860 3861 3862 3863 3864 3865 3866 3867 3868 3869 3870 3871 3872 3873 3874
    3875 3876 3877 3878 3879 3880 3881 3882 3883 3884 3885 3886 3887 3888 3889 3890 3891
    3892 3893 3894 3895 3896 3897 3898 3899 3900 3901 3902 3903 3904 3905 3906 3907 3908
    3909 3910 3911 3912 3913 3914 3915 3916 3917 3918 3919 3920 3921 3922 3923 3924 3925
    3926 3927 3928 3929 3930 3931 3932 3933 3934 3935 3936 3937 3938 3939 3940 3941 3942
    3943 3944 3945 3946 3947 3948 3949 3950 3951 3952 3953 3954 3955 3956 3957 3958 3959
    3960 3961 3962 3963 3964 3965 3966 3967 3968 3969 3970 3971 3972 3973 3974 3975 3976
    3977 3978 3979 3980 3981 
    3241 3242 3243 3244 3245 3246 3247 3248 3249 3250 3251 3252 3253 3254 3255 3256 3257
    3258 3259 3260 3261 3262 3263 3264 3265 3266 3267 3268 3269 3270 3271 3272 3273 3274
    3275 3276 3277 3278 3279 3280 3281 3282 3283 3284 3285 
    6133 6134 6135 6136 6137 6138 6139 6140 6141 6142 6143 6144 6145 6146 6147 6148 6149
    6150 6151 6152 6153 6154 6155 6156 6157 6158 6159 6160 6161 6162 6163 6164 6165 6166
    6167 6168 6169 6170 6171 6172 6173 6174 6175 6176 6177 6178 6179 6180 6181 6182 6183
    6184 6185 6186 6187 6188 6189 6190 6191 6192 6193 6194 6195 6196 6197 6198 6199 6200
    6201 6202 6203 6204 6205 6206 6207 6208 6209 6210 6211 6212 6213 6214 6215 6216 6217
    6218 6219 6220 6221 6222 6223 6224 6225 6226 6227 6228 6229 6230 6231 6232 6233 6234
    6235 6236 6237 6238 6239 6240 6241 6242 
    6001 6002 6003 6004 6005 6006 6007 6008 6009 6010 6011 6012 6013 6014
    6015 6016 6017 6018 6019 6020 6021 
    6022 6023 6024 6025 6026 6027 6028 6029 6030 6031 6032 6033 6034
    6035 6036 6037 6038 6039 6040 6041 6042 6043 6044 6045 6046 6047 6048
    6049 6050 6051 6052 6053 6054 6055 6056 6057 6058 6059 6060 6061 6062
    6063 6064 6065 6066 6067 6068 6069 6070 6071 6072 6073 6074 6075 6076
    6077 6078 6079 6080 6081 6082 6083 6084 6085 6086 6087 6088 6089 6090
    6091 6092 6093 6094 6095 6096 6097 6098 6099 6100 6101 6102 6103 6104
    6105 6106 6107 6108 6109 6110 6111 6112 6113 6114 6115 6116 6117 6118
    6119 6120 6121 6122 6123 6124 6125 6126 6127 6128 6129 6130 6131 
}

severe_winter = {
	73 171 173 175 176 180 182 186 187 192 196 210 211 213 214 288 386 394 451 457 459 460 486 489 505 508 509 515 516
    544 546 577 668 669 684 687 726 735 737 758 800 808 840 886 914 946 957 968 970 987 998 999 1003 1013 1080 1087 1093
    1112 1115 1118 1119 1120 1123 1130 1131 1134 1141 1142 1143 1144 1150 1160 1198 1219 1239 1245 1249 1780 1788 1793
    1819 1822 1824 1840 1873 1992 2014 2047 2050 2071 2084 2113 2128 2137 2147 2148 2152 2174 2175 2176 2211 2225
    2236 2237 2241 2246 2259 2260 2270 2271 2273 2278 2280 2284 2286 2287 2288 2353 2363 2414 2456 2513 2556 2588 2594
    2735 2801 2820 2836 2853 2860 2905 2906 2910 2921 2987 4072 4076 4077 4124 4230 4293 4294 4302 4303 4793 4795
    4796 4801 4802 4862 4863 4864 4865 4866 4870 4871 4872 4873 4874 4880 4881 4898 5137 5138 5139 5424 5425 5429 5430
    5431 5454 5462 5465 5466 5559 5581 5583 5587 5597 5463 5464 5915 5916 5917 5918 5931 5953

    6444 6445 6446 6447 6448 6449 6450 6451 6452 6453 6454 6455 6456 6457 6458 6459
    6460 6461 6462 6463 6464 6465 6466 6467 6468 6469 6470 6471 6472 6473 6474 6475
    6476 6477 6478 6479 6480 6481 6482 6483 6484 6485 6486 6487 6488 6489 6490 6491
    6492 6493 6494 6495 6496 6497 6498 6499 6500 6501 6502 6503 6504 6505 6506 6507
    6508 6509 6510 6511 6512 6513 6514 6515 6516 6517 6518 6519 6520 6521 6522 6523
    6524 6525 6526 6527 6528 6529 6530 6531 6532 6533 6534 6535 6536 6537 6538 6539
    6540 6541 6542 6543 6544 6545 6546 6547 6548 6549 6422 6423 6424 6425 6426 6427
    6428 6429 6430 6431 6432 6410 6411 6412 6413 6414 6415 6416 6417 6418 6419 6420
    6421
    6550 6551 6552 6553 6554 6555 6556 6557 6558 6559 6560 6561 6562 6563 6564 6565 6566
    6567 6568 6569 6570 6571 6572 6573 6574 6575 6576 6577 6578 6579 6580 6581 6582 6583
    6584 6585 6586 6587 6588 6589 6590 6591 6592 6593 6594 6595 6596 6597 6598 6599 6600
    6601 6602 6603 6604 6605 6606 6607 6608 6609 6610 6611 6612 6613 6614 6615 6616 6617
    6618 6619 6620 6621 6622 6623 6624 6625 6626 6627 6628 6629 6630 6631 6632 6633 6634
    6635 6636 6637 6638 6639 6640 6641 6642 6643 6644 6645 6646 6647 6648 6649 6650 6651
    6652 6653 6654 6655 6656 6657 6658 6659 6660 6661 6662 6663 6664 6665 6666 6667 6668
    6669 6670 6671 6672 6673 6674 6675 6676 6677 6678 6679 6680 6681 6682 6683 6684 6685
    6686 6687 6688 6689 6690 6691 6692 6693 6694 6695 6696 6697 6698
    3693 3694 3695 3696 3697 3698 3699 3700 3701 3702 3703 3704 3705 3706 3707 3708 3709
    3710 3711 3712 3713 3714 3715 3716 3717 3718 3719 3720 3721 3722 3723 3724 3725 3726
    3727 3728 3729 3730 3731 3732 3733 3734 3735 3736 3737 3738 3739 3740 3741 3742 3743
    3744 3745 3746 3747 3748 3749 3750 3751 3752 3753 3754 3755 3756 3757 3758 3759 3760
    3761 3762 
    3942 4244
}

impassable = {
	101 174 176 187 205 505 518 569 687 725 734 886 960 967 971 990 993 998 999
    1002 1003 1004 1005 1010 1122 1144 1163 1240 1562 1568 1569 1570
    1571 1572 1573 1574 1575 1576 1578 1580 1582 1583 1763 1819 1992 2012 2013 2028
    2057 2079 2084 2090 2093 2185 2271 2402 2456 2561 2563 2588 2594 2743 2942
    3146 3147 3148 3149 3150 3151 3152 3153 3154 3155 3156 3157 3158 3159 3160
    3161 3162 3163 3164 3165 3166 3167 3168 3169 3170 3171 3172 3173 3174 3175
    3176 3177 3178 3179 3180 3181 3182 3183
    3485 3486 3487 3521 3527 3538 3590 3655 3656 3657 5434 3440 3441 3442 3443
    3444 3445 3430 3431 3399 3400 3401 3402 3403 3404 3405 3406 3407 3408 3409
    3410 3411 3412 3413 3414 3022 3023 3024 3025
    3982 3983 3984 3985 3986 3987 3988 3989 3990 3991 3992 3993 3994 3995 3996
    3997 3998 3999 4000 4001 4002 4003 4004 4005 4006 4007 4008 4009 4010 4011
    4012 4013 4014 4015 4016 4017 4018 4019
    4481 4482 4483 4484
    763 794 2076 2114 2907 2970 3185 3186 3187 3188 3189 3193 3198 3199 3201 3215
    3216 3217 3219 3220 3221 3223 3224 3225 3226 3227 3228 3229 3230 3231 3232 3233
    3234 3235 3236 3237 3238 4097 4546 4588 5208 5310
}

mild_monsoon = {
    85 100 317 322 328 413 635 790 929 954 1056 1238 1242 1266 1765 1842 1846 1925 1931 2003 2004 2107 2188 2217 2317
    2535 2596 2612 2689 2750 2977 4093 5926
}
normal_monsoon = {
    15 90 95 255 286 325 326 327 484 676 896 934 1090 2203 2204 2215 2382 2609 2696 2729 2734 2746 2827 3000 3197 5231 5355 5601
}
severe_monsoon = {
    254 330 331 407 418 1864 2299 2976
}

equator_y_on_province_image = 656